L,L,L,W,W,W,W,W,W,W,W,W,W
L,L,L,W,W,W,W,W,W,W,W,W,W
W,L,L,L,W,W,W,W,W,W,W,W,W
W,W,L,L,W,W,W,W,W,W,W,W,W
W,W,W,W,W,W,W,W,W,W,W,W,W
W,W,W,W,W,W,W,W,W,W,W,W,W
L,W,W,W,W,W,W,W,W,W,W,W,W
L,L,W,W,W,W,W,W,W,W,W,W,W
L,L,L,W,W,W,W,W,W,W,W,W,W
L,L,L,L,L,L,L,L,L,L,L,W,W